border_size=1
usage=map

Xu          , Xu          , Xu          , Xu          , Uu          , Xu          , Uu          , Xu          , Xu          , Xu          , Xu          , Xu          , Xu          , Uu^Ii       , Uu^Ii       , Xu          , Xu          , Xu          , Xu          , Xu          , Xu          , Xu          , Uu          , Uu          , Ur          , Uu          , Uu          , Uu          
Xu          , Xu          , Xu          , Xu          , Uu^Vu       , Xu          , Uu          , Xu          , Xu          , Xu          , Xu          , Xu          , Xu          , Uu^Ii       , Uu^Ii       , Xu          , Xu          , Xu          , Xu          , Xu          , Xu          , Xu          , Uu          , Uu          , Ur          , Uu^Vud      , Uu          , Uu          
Xu          , Xu          , Uh          , Uu          , Uu          , Uu          , Uh          , Uu          , Uu          , Xu          , Xu          , Xu          , Uu^Vud      , Uu          , Xu          , Xu          , Xu          , Xu          , Xu          , Xu          , Ur          , Uu^Uf       , Uu          , Ur          , Xu          , Xu          , Xu          , Xu          
Uh          , Uh          , Xu          , Uu^Uf       , Xu          , Xu          , Xu          , Uu          , Xu          , Xu          , Xu          , Xu          , Ur          , Xu          , Xu          , Xu          , Xu          , Xu          , Uu          , Uu          , Co          , Ur          , Xu          , Xu          , Xu          , Xu          , Xu          , Xu          
Xu          , Xu          , Xu          , Xu          , Uu          , Xu          , Cud         , Cud         , Cud         , Xu          , Xu          , Xu          , Ur          , Uu^Uf       , Xu          , Xu          , Xu          , Xu          , Ur          , Co          , 3 Ko        , Co          , Xu          , Xu          , Xu          , Xu          , Xu          , Xu          
Xu          , Xu          , Uh          , Uh          , Uh          , Uu          , Cud         , 2 Kud       , Cud         , Uu          , Xu          , Xu          , Uu          , Uu          , Xu          , Xu          , Xu          , Xu          , Uu          , Co          , Co          , Co          , Xu          , Xu          , Xu          , Xu          , Xu          , Xu          
Xu          , Xu          , Xu          , Uh          , Xu          , Uu          , Ur          , Cud         , Uu          , Uu          , Xu          , Xu          , Xu          , Ur          , Ur          , Xu          , Xu          , Uu^Vud      , Uu          , Ur          , Ur          , Uh          , Xu          , Xu          , Xu          , Xu          , Xu          , Xu          
Xu          , Xu          , Xu          , Xu          , Xu          , Xu          , Ur          , Ur          , Uu          , Xu          , Xu          , Xu          , Xu          , Uu          , Uh          , Uh          , Ur          , Ur          , Uh          , Uh          , Xu          , Xu          , Xu          , Xu          , Xu          , Xu          , Xu          , Xu          
Xu          , Xu          , Xu          , Xu          , Uu          , Xu          , Ur          , Uu          , Uu^Vu       , Uu^Uf       , Uu          , Ur          , Ur          , Uu^Uf       , Xu          , Xu          , Xu          , Ur          , Ur          , Ur          , Uu          , Xu          , Xu          , Xu          , Xu          , Xu          , Xu          , Xu          
Xu          , Xu          , Uu^Vu       , Uu          , Ur          , Uu          , Ur          , Xu          , Xu          , Ur          , Uh          , Uu          , Xu          , Ur          , Xu          , Ur          , Uu^Vud      , Xu          , Xu          , Ur          , Uu          , Uu^Uf       , Xu          , Xu          , Xu          , Xu          , Xu          , Xu          
Xu          , Xu          , Xu          , Xu          , Xu          , Ur          , Ur          , Xu          , Xu          , Xu          , Xu          , Xu          , Uh          , Uu          , Xu          , Xu          , Ur          , Uh          , Uh          , Xu          , Uu          , Uu          , Xu          , Xu          , Xu          , Xu          , Xu          , Xu          
Xu          , Xu          , Xu          , Xu          , Xu          , Uu          , Ur          , Uu          , Uu^Vu       , Xu          , Xu          , Xu          , Uh          , Uu          , Ur          , Ur          , Ur          , Uu          , Uh          , Xu          , Uu          , Uu          , Xu          , Xu          , Xu          , Xu          , Xu          , Xu          
Xu          , Xu          , Xu          , Xu          , Xu          , Xu          , Uu^Uf       , Ur          , Xu          , Ur          , Ur          , Xu          , Xu          , Uh          , Ur          , Xu          , Xu          , Uu^Vud      , Xu          , Xu          , Ur          , Ur          , Xu          , Xu          , Xu          , Xu          , Xu          , Xu          
Xu          , Xu          , Xu          , Xu          , Xu          , Xu          , Uu^Uf       , Ur          , Xu          , Xu          , Xu          , Ur          , Uu          , Ur          , Ur          , Xu          , Xu          , Xu          , Xu          , Xu          , Ur          , Uu          , Xu          , Xu          , Xu          , Xu          , Xu          , Xu          
Xu          , Xu          , Xu          , Xu          , Xu          , Xu          , Xu          , Ur          , Ur          , Xu          , Xu          , Ur          , Uh          , Uh          , Xu          , Xu          , Xu          , Xu          , Xu          , Xu          , Ur          , Uu^Uf       , Uu          , Uh          , Uh          , Xu          , Xu          , Xu          
Xu          , Xu          , Xu          , Xu          , Xu          , Xu          , Xu          , Ur          , Ur          , Xu          , Xu          , Uu          , Uu^Uf       , Xu          , Xu          , Xu          , Xu          , Xu          , Xu          , Xu          , Ur          , Ur          , Xu          , Uu          , Uu          , Ur          , Xu          , Xu          
Xu          , Xu          , Xu          , Xu          , Xu          , Xu          , Xu          , Ur          , Uu          , Uu          , Uu          , Ur          , Xu          , Xu          , Xu          , Xu          , Xu          , Xu          , Xu          , Uu^Vud      , Uu          , Xu          , Xu          , Xu          , Xu          , Ur          , Uu^Vud      , Uu          
Xu          , Xu          , Xu          , Xu          , Xu          , Xu          , Uu          , Ur          , Xu          , Uu^Vu       , Ur          , Uu          , Uu          , Xu          , Xu          , Xu          , Xu          , Xu          , Xu          , Ur          , Ur          , Uu          , Ur          , Xu          , Xu          , Xu          , Uu^Uf       , Uu^Uf       
Xu          , Xu          , Xu          , Xu          , Xu          , Xu          , Uu^Uf       , Ur          , Xu          , Xu          , Xu          , Xu          , Ur          , Uu^Vu       , Xu          , Xu          , Xu          , Xu          , Xu          , Xu          , Xu          , Xu          , Xu          , Ur          , Uu          , Xu          , Xu          , Xu          
Xu          , Xu          , Xu          , Xu          , Ur          , Ur          , Uu          , Uu          , Xu          , Xu          , Xu          , Xu          , Uh          , Ur          , Ur          , Xu          , Xu          , Xu          , Xu          , Xu          , Xu          , Xu          , Xu          , Uu          , Uh          , Xu          , Xu          , Xu          
Xu          , Xu          , Cud         , Rr^Vd       , Rr          , Uu          , Xu          , Xu          , Xu          , Xu          , Xu          , Xu          , Xu          , Uh          , Uu          , Ur          , Uu          , Uu^Uf       , Uu          , Xu          , Xu          , Xu          , Xu          , Uu          , Uh          , Xu          , Xu          , Xu          
Cud         , Cud         , 1 Kud       , Cud         , Rr          , Xu          , Xu          , Xu          , Xu          , Xu          , Xu          , Xu          , Xu          , Xu          , Xu          , Ur          , Uh          , Uu          , Ur          , Uu          , Uu          , Xu          , Uu          , Uu          , Ur          , Xu          , Xu          , Xu          
Cud         , Cud         , Cud         , Cud         , Rr          , Xu          , Xu          , Xu          , Xu          , Xu          , Xu          , Xu          , Xu          , Xu          , Xu          , Xu          , Xu          , Xu          , Xu          , Ur          , Uu          , Uu^Vud      , Ur          , Ur          , Xu          , Xu          , Xu          , Xu          
Cud         , Cud         , Cud         , Cud         , Rr          , Xu          , Xu          , Xu          , Xu          , Xu          , Xu          , Xu          , Xu          , Xu          , Xu          , Xu          , Xu          , Xu          , Xu          , Ur          , Uu          , Uu          , Ur          , Ur          , Xu          , Xu          , Xu          , Xu          
