border_size=1
usage=map

Ce          , Ce          , Ce          , Ce          , Gg          , Gs^Fp       , Gg          , Gg          , Gg          , Gg          , Gs^Fp       , Gg          , Gs^Fp       , Gs^Fp       , Gs^Fp       , Gs^Fp       , Gs^Fp       , Gs^Fp       , Gg          , Gs^Fp       , Gs^Fp       , Gg          , Gs^Fds      , Gs^Fds      , Gs^Fp       , Gs^Fp       , Gd^Fdf      , Gs^Fp       , Gs^Fds      , Gs^Fp       , Gg          , Re          , Gg          , Gs^Fp       , Gs^Fp       , Gg          , Gg          , Gg          , Ce          , Ce          , Ce          , Ce          
Ce          , 1 Ke        , Ce          , Ce          , Gg          , Gs^Fp       , Gg          , Gg          , Gg          , Gg          , Gs^Fp       , Gg          , Gs^Fp       , Gs^Fds      , Gs^Fds      , Gs^Fds      , Gs^Fp       , Gs^Fp       , Gg          , Gs^Fp       , Gs^Fp       , Gg          , Gs^Fds      , Gs^Fds      , Gs^Fp       , Gd^Fdf      , Gs^Fp       , Gs^Fds      , Gs^Fds      , Gs^Fp       , Gg          , Re          , Gg^Ve       , Gs^Fp       , Gs^Fp       , Gg          , Gg          , Gg          , Ce          , Ce          , 3 Ket       , Ce          
Ce          , Ce          , Ce          , Ce          , Gg          , Gg          , Gs^Fp       , Gs^Fp       , Gg          , Gs^Fp       , Gs^Fds      , Gg          , Gs^Fp       , Gs^Fp       , Gg          , Gs^Fp       , Gg          , Gs^Fp       , Gs^Fp       , Gg          , Gg          , Gg          , Gg          , Gg          , Ww          , Ww          , Ww          , Ww          , Gg          , Gg          , Gg          , Re          , Re          , Gs^Fds      , Gs^Fds      , Gs^Fds      , Gg          , Gs^Fp       , Ce          , Ce          , Ce          , Ce          
Ce          , Ce          , Gs^Fp       , Gg          , Gg          , Gg          , Gs^Fp       , Gs^Fds      , Gs^Fp       , Gs^Fds      , Gd^Fdf      , Gg          , Gs^Fp       , Gs^Fp       , Re          , Gg^Ve       , Gs^Fp       , Gs^Fp       , Gs^Fp       , Gs^Fp       , Gg          , Gg          , Gs^Fp       , Gs^Fp       , Hh          , Gg          , Gg          , Ww          , Gs^Fp       , Gg          , Gs^Fds      , Gs^Fds      , Re          , Gg          , Gs^Fp       , Gs^Fp       , Gd^Fdf      , Gs^Fp       , Ce          , Ce          , Ce          , Ce          
Gg          , Gg          , Gg          , Gg          , Gs^Fp       , Gg          , Gs^Fds      , Gg          , Gs^Fp       , Gs^Fp       , Gs^Fp       , Gg          , Re          , Re          , Gg          , Re          , Re          , Gg          , Gs^Fds      , Gs^Fds      , Gs^Fds      , Gg          , Gg          , Gs^Fp       , Hh          , Hh          , Gs^Fp       , Gs^Fp       , Gs^Fp       , Gs^Fp       , Gs^Fds      , Gs^Fp       , Gs^Fp       , Re          , Re          , Gs^Fp       , Gg          , Gd^Fdf      , Gg          , Ce          , Ce          , Ce          
Gg          , Gg          , Gg          , Gs^Fp       , Re          , Re          , Re          , Gs^Fds      , Re          , Gs^Fp       , Re          , Re          , Gs^Fp       , Gs^Fp       , Gs^Fds      , Gs^Fp       , Re          , Gg          , Gs^Fp       , Gs^Fds      , Gg          , Gs^Fp       , Gs^Fp       , Gs^Fp       , Gs^Fds      , Gs^Fp       , Gs^Fp       , Gg          , Gs^Fp       , Gg          , Gs^Fp       , Gg          , Gs^Fp       , Gg          , Re          , Gs^Fds      , Gs^Fds      , Gs^Fp       , Re          , Re          , Gg          , Gg          
Gg          , Gg          , Gg          , Gg          , Re          , Gg^Ve       , Gs^Fp       , Re          , Gs^Fp       , Re          , Gs^Fp       , Gg          , Gs^Fds      , Gg          , Gs^Fp       , Gg          , Re          , Gg          , Gs^Fp       , Gg          , Gd^Fdf      , Gs^Fp       , Gs^Fp       , Gs^Fp       , Gg          , Gs^Fds      , Gs^Fp       , Gs^Fp       , Gg          , Gg          , Gg          , Gg          , Gs^Fp       , Gg          , Re          , Gg          , Re          , Re          , Gs^Fds      , Gs^Fp       , Gg          , Gg          
Gs^Fp       , Gs^Fp       , Gs^Fp       , Gs^Fp       , Re          , Gs^Fp       , Gs^Fds      , Gs^Fds      , Gs^Fp       , Gg          , Gg          , Gg          , Gg          , Gs^Fds      , Gs^Fds      , Gs^Fds      , Gs^Fp       , Re          , Re          , Gs^Fp       , Re          , Gg          , Gg          , Gg^Ve       , Gs^Fp       , Gs^Fds      , Gs^Fp       , Gg          , Gs^Fp       , Gs^Fds      , Gs^Fds      , Gs^Fp       , Gs^Fp       , Re          , Gg          , Re          , Gs^Fp       , Gs^Fds      , Hh          , Hh          , Gs^Fp       , Gs^Fp       
Gg          , Gg          , Gg          , Gs^Fds      , Gs^Fp       , Re          , Gd^Fdf      , Gs^Fds      , Gs^Fp       , Hh          , Hh          , Gs^Fp       , Gg          , Gg          , Gs^Fp       , Gs^Fds      , Gs^Fp       , Gg          , Gs^Fp       , Re          , Gs^Fp       , Re          , Re          , Re          , Re          , Gg          , Gg          , Gs^Fp       , Gs^Fp       , Gs^Fds      , Gs^Fp       , Ww          , Gs^Fp       , Re          , Gg^Ve       , Re          , Gs^Fp       , Hh          , Hh          , Hh          , Gs^Fp       , Gs^Fp       
Gg          , Gg          , Gg          , Gs^Fds      , Re          , Re          , Gg          , Gd^Fdf      , Gg          , Hh          , Hh          , Gg          , Ww          , Gg          , Gg          , Gs^Fp       , Gs^Fds      , Gs^Fp       , Gg          , Gs^Fp       , Re          , Re          , Gg          , Gs^Fp       , Re          , Gg          , Gs^Fp       , Gs^Fp       , Hh          , Gg          , Gs^Fp       , Ww          , Ww          , Re          , Gg          , Re          , Re          , Gs^Fds      , Gs^Fds      , Hh          , Hh          , Hh          
Gg          , Gg          , Gs^Fp       , Gs^Fp       , Re          , Gs^Fp       , Gs^Fp       , Gg          , Gs^Fds      , Hh          , Gg          , Gs^Fp       , Gs^Fp       , Gs^Fp       , Gs^Fp       , Gs^Fds      , Gg          , Gs^Fp       , Re          , Re          , Gs^Fp       , Gs^Fp       , Gs^Fp       , Gg          , Gs^Fds      , Re          , Re          , Gs^Fp       , Hh          , Hh          , Gs^Fp       , Ww          , Gs^Fp       , Re          , Gs^Fp       , Gg          , Gd^Fdf      , Re          , Gs^Fds      , Hh          , Hh          , Hh          
Gg          , Gg          , Gs^Fds      , Gg          , Gs^Fp       , Re          , Gs^Fp       , Gs^Fds      , Gs^Fds      , Gs^Fp       , Gs^Fp       , Gd^Fdf      , Gg          , Gg          , Gs^Fp       , Gs^Fp       , Re          , Re          , Gs^Fp       , Gs^Fp       , Gg          , Gg          , Gs^Fp       , Gg          , Gs^Fp       , Gs^Fds      , Gs^Fp       , Re          , Gg          , Hh          , Gs^Fp       , Gs^Fp       , Gs^Fp       , Re          , Gs^Fp       , Gs^Fp       , Gd^Fdf      , Re          , Re          , Gd^Fdf      , Hh          , Hh          
Gg          , Gg          , Gs^Fds      , Gs^Fds      , Gs^Fp       , Re          , Re          , Gs^Fp       , Gs^Fp       , Gs^Fp       , Gg          , Gs^Fds      , Gs^Fds      , Gs^Fds      , Re          , Re          , Gg          , Gs^Fp       , Gs^Fp       , Gg^Fet      , Gs^Fp       , Gs^Fds      , Gs^Fds      , Gs^Fds      , Gg^Fet      , Gs^Fds      , Gs^Fp       , Re          , Re          , Hh          , Hh          , Gs^Fp       , Gg          , Re          , Gs^Fp       , Gs^Fp       , Gs^Fp       , Re          , Gs^Fds      , Re          , Re          , Re          
Gs^Fp       , Gs^Fp       , Gs^Fds      , Gg          , Gg          , Gs^Fp       , Re          , Gg^Ve       , Re          , Re          , Re          , Re          , Re          , Re          , Re          , Gg          , Gg^Ve       , Gg          , Gd^Fdf      , Gs^Fp       , Gs^Fp       , Gs^Fp       , Gs^Fds      , Gs^Fds      , Gs^Fp       , Gs^Fp       , Gs^Fp       , Gs^Fp       , Gs^Fp       , Re          , Re          , Gg          , Re          , Re          , Gs^Fds      , Gs^Fds      , Gs^Fp       , Re          , Gs^Fp       , Gs^Fds      , Gs^Fp       , Gs^Fp       
Gs^Fp       , Gs^Fp       , Gs^Fp       , Gs^Fp       , Re          , Gs^Fp       , Re          , Re          , Gg          , Gg          , Gs^Fp       , Gg          , Gg          , Gs^Fp       , Gs^Fp       , Re          , Gs^Fp       , Gs^Fp       , Gs^Fp       , Gs^Fp       , Chr         , Chr         , Chr         , Gs^Fp       , Gd^Fdf      , Gg          , Gs^Fds      , Gg          , Gs^Fp       , Gg^Fet      , Re          , Re          , Gs^Fp       , Gg          , Gs^Fds      , Gs^Fds      , Gg          , Re          , Gs^Fp       , Gs^Fp       , Gs^Fp       , Gs^Fp       
Gs^Fp       , Gs^Fp       , Re          , Re          , Gg          , Re          , Re          , Gs^Fds      , Gg          , Gg          , Gs^Fp       , Gg          , Gs^Fds      , Gs^Fds      , Gg          , Re          , Gg          , Gg^Fet      , Gs^Fds      , Gs^Fds      , Chr         , 5 Kh        , Chr         , Gs^Fp       , Gs^Fp       , Gg          , Gs^Fds      , Gg          , Gg          , Gs^Fp       , Re          , Gg          , Gg          , Gg          , Gs^Fp       , Gg          , Re          , Re          , Re          , Gs^Fp       , Gg          , Gg          
Re          , Re          , Gs^Fp       , Gg          , Gs^Fp       , Gs^Fp       , Re          , Gs^Fds      , Gg          , Gg          , Gg          , Gs^Fp       , Gg          , Gg          , Gs^Fp       , Re          , Gs^Fp       , Gs^Fp       , Gg          , Gs^Fds      , Gs^Fp       , Chr         , Gs^Fp       , Gs^Fp       , Gs^Fp       , Gg          , Gs^Fds      , Gs^Fds      , Re          , Re          , Gs^Fds      , Gs^Fp       , Gd^Fdf      , Gs^Fp       , Gs^Fp       , Gs^Fp       , Gg^Ve       , Gg          , Re          , Gs^Fp       , Gs^Fp       , Gs^Fp       
Gs^Fp       , Gs^Fp       , Gs^Fp       , Gs^Fds      , Gs^Fds      , Gd^Fdf      , Re          , Gg          , Gs^Fp       , Gs^Fds      , Gg          , Gg          , Gg          , Gg          , Gs^Fp       , Re          , Gs^Fp       , Gs^Fds      , Gs^Fp       , Gs^Fp       , Gs^Fp       , Gs^Fp       , Gs^Fp       , Gg^Fet      , Gs^Fp       , Gg^Ve       , Re          , Re          , Gs^Fds      , Gs^Fds      , Gs^Fp       , Gg          , Gs^Fp       , Gs^Fp       , Gs^Fp       , Gs^Fp       , Gs^Fp       , Gs^Fp       , Re          , Gs^Fp       , Gs^Fp       , Gs^Fp       
Gs^Fds      , Gs^Fds      , Gg          , Gs^Fp       , Hh          , Gs^Fp       , Re          , Gs^Fp       , Gs^Fp       , Gs^Fp       , Gs^Fds      , Gs^Fp       , Gs^Fp       , Gg          , Gg          , Re          , Gs^Fp       , Gs^Fp       , Gg          , Gs^Fp       , Gs^Fp       , Gg          , Gg          , Gs^Fp       , Re          , Re          , Gg          , Gs^Fp       , Gg          , Gg          , Gs^Fp       , Gs^Fp       , Gs^Fp       , Gg          , Gs^Fp       , Gg          , Gd^Fdf      , Gg          , Re          , Gs^Fp       , Gs^Fds      , Gs^Fds      
Gs^Fp       , Gs^Fp       , Gs^Fp       , Hh          , Hh          , Hh          , Gs^Fp       , Re          , Re          , Gg          , Gg          , Gs^Fds      , Gg          , Gs^Fp       , Gs^Fp       , Re          , Re          , Gg          , Gg          , Gg^Fet      , Gs^Fds      , Gs^Fp       , Re          , Re          , Gs^Fp       , Gg          , Gs^Fp       , Gs^Fp       , Gg          , Gg          , Gs^Fp       , Gg          , Gs^Fds      , Gs^Fds      , Gg          , Gs^Fp       , Gg          , Gs^Fp       , Re          , Gs^Fp       , Gs^Fds      , Gs^Fds      
Gg          , Gg          , Gs^Fp       , Hh          , Hh          , Gs^Fds      , Gs^Fds      , Gg^Ve       , Re          , Gs^Fp       , Gs^Fp       , Gs^Fds      , Gg          , Gd^Fdf      , Ww          , Ww          , Gs^Fp       , Re          , Gg          , Gg          , Gs^Fds      , Gs^Fds      , Re          , Gs^Fp       , Gg          , Gg          , Gg          , Gs^Fds      , Gg          , Gg          , Ww          , Gs^Fp       , Gs^Fds      , Gg          , Gs^Fp       , Gg          , Gs^Fp       , Gd^Fdf      , Re          , Gs^Fp       , Gs^Fp       , Gs^Fp       
Gg          , Gg          , Gg          , Gs^Fp       , Gs^Fp       , Gs^Fp       , Gg          , Gs^Fds      , Gs^Fp       , Re          , Gs^Fp       , Gs^Fp       , Gs^Fp       , Ww          , Gs^Fp       , Ww          , Gs^Fp       , Re          , Gg          , Gs^Fp       , Gs^Fp       , Re          , Gs^Fp       , Gg          , Hh          , Gg          , Gs^Fp       , Gg          , Ww          , Ww          , Gg          , Gs^Fp       , Gs^Fp       , Hh          , Hh          , Gs^Fp       , Gg          , Gs^Fds      , Re          , Gg          , Gs^Fp       , Gs^Fp       
Gg          , Gg          , Gs^Fds      , Gs^Fds      , Gg          , Gg          , Gg          , Gs^Fds      , Gs^Fds      , Re          , Gs^Fp       , Gg          , Gg          , Gg          , Gg          , Ww          , Gs^Fp       , Re          , Re          , Gs^Fp       , Re          , Re          , Gs^Fp       , Gs^Fp       , Hh          , Hh          , Gd^Fdf      , Gd^Fdf      , Ww          , Ww          , Gs^Fds      , Gs^Fp       , Gg          , Hh          , Gs^Fp       , Gg          , Gs^Fds      , Gs^Fds      , Re          , Gs^Fds      , Gs^Fds      , Gs^Fp       
Gs^Fp       , Gs^Fp       , Gs^Fp       , Gs^Fp       , Gg          , Hh          , Hh          , Gs^Fp       , Re          , Re          , Gg          , Gs^Fp       , Gg          , Gs^Fp       , Gg          , Gs^Fp       , Gs^Fp       , Gs^Fp       , Re          , Gg^Ve       , Re          , Gs^Fp       , Gs^Fp       , Gs^Fds      , Hh          , Gg          , Gg          , Gg          , Gs^Fp       , Gg          , Gs^Fp       , Gs^Fds      , Gs^Fds      , Gg          , Gs^Fp       , Gs^Fds      , Gs^Fp       , Re          , Gs^Fp       , Gs^Fp       , Gs^Fds      , Gs^Fp       
Gg          , Gg          , Gg          , Gs^Fp       , Gg          , Hh          , Hh          , Gs^Fp       , Re          , Gg          , Gg          , Gg          , Gd^Fdf      , Gs^Fp       , Gs^Fds      , Gs^Fds      , Gs^Fp       , Gs^Fp       , Re          , Re          , Gs^Fds      , Re          , Re          , Gs^Fds      , Gs^Fp       , Hh          , Gs^Fp       , Gs^Fp       , Gs^Fp       , Gs^Fp       , Gs^Fp       , Gg          , Gg          , Gg          , Gs^Fp       , Gs^Fp       , Re          , Re          , Gs^Fp       , Gg          , Gs^Fp       , Gs^Fp       
Gs^Fp       , Gs^Fp       , Gg          , Gg          , Gs^Fds      , Hh          , Re          , Re          , Gs^Fp       , Gs^Fp       , Gg          , Gs^Fp       , Gd^Fdf      , Gg          , Gs^Fds      , Gg          , Re          , Re          , Gs^Fp       , Gs^Fds      , Gg          , Gs^Fp       , Gs^Fp       , Re          , Gs^Fp       , Gs^Fp       , Gs^Fp       , Gs^Fds      , Gs^Fds      , Gg          , Gs^Fp       , Gs^Fp       , Gs^Fds      , Gs^Fp       , Gg^Ve       , Re          , Re          , Gs^Fp       , Gs^Fds      , Gg          , Gg          , Gg          
Gs^Fds      , Gs^Fds      , Gg          , Gg          , Gs^Fds      , Gg          , Re          , Gg^Ve       , Gs^Fds      , Gs^Fp       , Gs^Fp       , Gg          , Gs^Fp       , Gd^Fdf      , Re          , Re          , Gg          , Gs^Fp       , Gs^Fp       , Gs^Fds      , Gg          , Gg          , Gg          , Re          , Re          , Gg          , Gs^Fp       , Gg          , Gs^Fds      , Gg          , Gs^Fp       , Gd^Fdf      , Re          , Re          , Gs^Fp       , Gs^Fp       , Gs^Fds      , Re          , Gg          , Gs^Fp       , Gg          , Gg          
Gg          , Gg          , Gg          , Gg          , Gg          , Gg          , Re          , Gs^Fds      , Gd^Fdf      , Gs^Fds      , Gs^Fp       , Gs^Fp       , Re          , Re          , Gs^Fds      , Gs^Fds      , Gs^Fds      , Gs^Fp       , Gg          , Gs^Fp       , Gg          , Gs^Fp       , Gs^Fp       , Gg          , Gs^Fp       , Re          , Re          , Gg          , Gs^Fp       , Gg          , Gs^Fp       , Re          , Gg          , Gs^Fp       , Gg          , Gs^Fds      , Gs^Fds      , Re          , Re          , Gs^Fp       , Gs^Fp       , Gs^Fp       
Ce          , Ce          , Ce          , Gg          , Gs^Fp       , Gg          , Re          , Gg          , Re          , Gs^Fp       , Re          , Re          , Gs^Fp       , Gs^Fp       , Gs^Fp       , Gg          , Gs^Fp       , Gs^Fp       , Gs^Fp       , Gs^Fp       , Gs^Fds      , Gs^Fds      , Gd^Fdf      , Gs^Fp       , Gg          , Gs^Fp       , Gs^Fds      , Re          , Gs^Fp       , Gg          , Re          , Re          , Gs^Fp       , Gs^Fp       , Gs^Fp       , Gg          , Gg          , Gg          , Ce          , Ce          , Ce          , Ce          
Ce          , Ce          , Ce          , Ce          , Ce          , Re          , Gg          , Re          , Gg          , Re          , Gd^Fdf      , Gg          , Gg          , Gg          , Gg          , Gs^Fp       , Gg          , Gs^Fp       , Gs^Fp       , Gg          , Gs^Fp       , Gs^Fds      , Gs^Fds      , Gg          , Gs^Fp       , Gs^Fds      , Gs^Fds      , Re          , Re          , Gs^Fp       , Re          , Gg          , Gg          , Gg          , Gs^Fp       , Gg          , Gs^Fp       , Ce          , Ce          , Ce          , Ce          , Ce          
Ce          , 2 Ket       , Ce          , Ce          , Ce          , Gs^Fp       , Gs^Fp       , Gg          , Gs^Fds      , Gs^Fp       , Gs^Fds      , Gg          , Gs^Fp       , Gg          , Gs^Fds      , Gs^Fds      , Gs^Fds      , Gs^Fds      , Gs^Fp       , Gs^Fp       , Gg          , Gg          , Gs^Fp       , Gg          , Gs^Fp       , Gg^Ve       , Re          , Re          , Gs^Fp       , Re          , Gs^Fp       , Gg          , Gs^Fds      , Gs^Fds      , Gs^Fds      , Gs^Fp       , Gs^Fp       , Ce          , Ce          , Ce          , 4 Ket       , Ce          
Ce          , Ce          , Ce          , Ce          , Ce          , Gs^Fp       , Gs^Fp       , Gg          , Gs^Fp       , Gs^Fds      , Gs^Fds      , Gg          , Gs^Fp       , Gg          , Gs^Fp       , Gs^Fp       , Gs^Fp       , Gs^Fp       , Gs^Fp       , Gs^Fds      , Gg          , Gg          , Gs^Fp       , Gg          , Gs^Fp       , Gg          , Re          , Re          , Gs^Fp       , Re          , Gs^Fp       , Gg          , Gs^Fp       , Gs^Fp       , Gs^Fp       , Gs^Fp       , Gs^Fp       , Ce          , Ce          , Ce          , Ce          , Ce          
