border_size=1
usage=map

Ch          , Ch          , Gg          , Ch          , Gg          , Ch          , Gg          , Ch          , Gg          , Ch          , Gg          , Ch          , Gg          , Ch          , Rrc         , Rrc         , Ch          , Rrc         , Rrc         , Ch          , Gg          , Ch          , Gg          , Ch          , Gg          , Ch          , Gg          , Ch          , Gg          , Ch          , Gg          , Ch          , Ch          
Ch          , Ch          , Gg          , Ch          , Gg          , Ch          , Gg          , Ch          , Gg          , Ch          , Gg          , Ch          , Gg          , Ch          , Rrc         , Rrc         , Ch          , Rrc         , Rrc         , Ch          , Gg          , Ch          , Gg          , Ch          , Gg          , Ch          , Gg          , Ch          , Gg          , Ch          , Gg          , Ch          , Ch          
Gg          , Gg          , Gg          , Gg          , Gg          , Gg          , Gg^Efm      , Gg          , Gg          , Gg          , Gg          , Gg          , Gg          , Gg          , Gg          , Ch          , 1 Kh        , Ch          , Gg          , Gg          , Gg          , Gg          , Gg          , Gg          , Gg          , Gg          , Gg          , Gg          , Gg          , Gg          , Gg          , Gg          , Gg          
Gg          , Gg          , Gg          , Gg          , Gg          , Gg          , Gg^Efm      , Gg^Efm      , Gg          , Gg          , Gg          , Gg          , Gg          , Gg          , Rrc         , Ch          , Ch          , Ch          , Gg          , Gg          , Gg          , Gg          , Gg^Vh       , Gg          , Gg          , Gg          , Gg^Efm      , Gg          , Gg          , Gg          , Gg          , Gg          , Gg          
Gg          , Gg          , Gg          , Gg          , Gg^Vh       , Gg          , Gg          , Gg          , Gg          , Gg          , Gs^Fp       , Gg          , Rrc         , Rrc         , Gg          , Gg          , Gg          , Rrc         , Rrc         , Gg          , Gg          , Gg          , Gg          , Gg          , Gg          , Gg^Efm      , Gg          , Gg          , Gg          , Gg          , Gs^Fp       , Gs^Fp       , Gs^Fp       
Gg          , Gg          , Gg          , Gg          , Gg          , Gg          , Gg          , Gg          , Gg          , Gg          , Gg          , Rrc         , Gg          , Gg          , Gg^Efm      , Gg          , Gg^Efm      , Gg          , Gg^Efm      , Rrc         , Rrc         , Gg          , Gg          , Gg          , Gg          , Gg          , Gg          , Gg          , Gg          , Gg          , Gs^Fp       , Gs^Fp       , Gs^Fp       
Gg          , Gg          , Gg^Efm      , Gg          , Gg          , Gg^Efm      , Gg          , Gg          , Gg          , Gg          , Gg          , Rrc         , Gg          , Gg^Efm      , Gg          , Gg^Efm      , Gg          , Gg^Efm      , Gg          , Gg          , Rrc         , Gg          , Gs^Fp       , Gs^Fp       , Gg          , Gg          , Gg^Efm      , Gg^Efm      , Gg          , Gg          , Gg          , Gs^Fp       , Gs^Fp       
Gg          , Gg          , Gg          , Gg          , Gg          , Gg          , Gg          , Gg          , Gg          , Gg          , Gg          , Rrc         , Gg          , Gg          , Gg          , Gg          , Gg          , Gg          , Gg^Vh       , Gg          , Rrc         , Gg          , Gg          , Gs^Fp       , Gg          , Gg          , Gg^Efm      , Gg^Efm      , Gg          , Gg^Vh       , Gg          , Gs^Fp       , Gs^Fp       
Gg          , Gg          , Gg          , Gg          , Gs^Fp       , Hh          , Hh          , Gg^Efm      , Gg          , Gg          , Gg          , Rrc         , Gg          , Gg          , Gg          , Gg          , Gg          , Gg          , Gg          , Gg          , Rrc         , Gg          , Gg^Efm      , Gg          , Gg^Efm      , Gg          , Gg          , Gg          , Gg          , Gg          , Ww          , Ww          , Ww          
Gg          , Gg          , Gg          , Gg          , Gg          , Gs^Fp       , Hh          , Gg          , Gg          , Gg^Vh       , Gg          , Rrc         , Gg          , Gg          , Gg          , Gg          , Gs^Fp       , Gg          , Gg^Efm      , Gg          , Gg          , Rrc         , Rrc         , Gg^Efm      , Gg^Efm      , Gg          , Gg          , Gg          , Gg          , Gg          , Ww          , Gs^Fp       , Gs^Fp       
Gg          , Gg          , Gg          , Gg          , Gg          , Gs^Fp       , Gg          , Gg          , Gg          , Gg          , Gg          , Rrc         , Gg          , Gg          , Gg          , Gg          , Gg          , Gg          , Gg          , Gg          , Gg          , Gg          , Gg          , Rrc         , Gg^Vh       , Gg          , Gg          , Gg          , Ww          , Ww          , Gs^Fp       , Gs^Fp       , Gs^Fp       
Gg          , Gg          , Gg          , Gg          , Gg          , Gg          , Gg^Efm      , Gg          , Gg^Efm      , Gg          , Gg          , Rrc         , Gg          , Gg^Efm      , Gg^Efm      , Gg          , Gg          , Gg          , Gg          , Gg          , Gs^Fp       , Gg          , Ww          , Ww          , Ww^Bsb|     , Gg          , Ww          , Ww          , Gg          , Gg          , Gs^Fp       , Gs^Fp       , Gs^Fp       
Gg          , Gg          , Gg          , Gg          , Hh          , Gg^Efm      , Gg          , Gg^Efm      , Gg          , Gg          , Gg          , Rrc         , Gg          , Gg^Efm      , Gg          , Gg          , Gg          , Gg          , Gg          , Gs^Fp       , Ww          , Ww          , Gg          , Gg          , Rrc         , Ww          , Gg          , Gg          , Gg^Efm      , Gg          , Gg          , Gs^Fp       , Gs^Fp       
Gg          , Gg          , Gg          , Hh          , Hh          , Hh          , Gg          , Gg          , Gg          , Gg^Vh       , Gg          , Rrc         , Rrc         , Gg          , Rrc         , Rrc         , Rrc         , Gg          , Ww          , Ww          , Gg          , Gg          , Gg          , Gg          , Gg          , Rrc         , Rrc         , Gg          , Gg          , Gg^Efm      , Gg          , Gg          , Gg          
Gg          , Gg          , Gg          , Gg          , Hh          , Hh          , Gg          , Gg          , Gg          , Gg          , Gg          , Rrc         , Gg          , Rrc         , Gg          , Gg          , Gg          , Rrc         , Ww^Bsb\     , Gg^Wm       , Gg          , Gg          , Gg          , Gs^Fp       , Gs^Fp       , Gs^Fp       , Rrc         , Gg          , Gg          , Gg          , Gg          , Gg          , Gg          
Gg          , Gg          , Gg          , Gg          , Gg          , Gg          , Gg          , Gg          , Gg          , Gg^Efm      , Gg          , Rrc         , Gg          , Gg          , Gg          , Gg          , Ww          , Ww          , Rrc         , Gg^Vh       , Gg          , Gg          , Gg          , Gg          , Gg          , Gg          , Rrc         , Gg          , Gg          , Gg          , Gg          , Gg          , Gg          
Gg          , Gg          , Gg^Efm      , Gg          , Gg          , Gg          , Gg          , Gg          , Gs^Fp       , Gg          , Rrc         , Rrc         , Gg          , Gg          , Ww          , Ww          , Gg          , Gg          , Rrc         , Gg          , Gg          , Gg          , Gg          , Gg          , Gg          , Gg          , Rrc         , Gg          , Gg          , Gg          , Gg^Efm      , Gg          , Gg          
Gg          , Gg          , Gg          , Gg          , Gg^Efm      , Gg          , Gg          , Gs^Fp       , Rrc         , Rrc         , Gg^Efm      , Gg          , Ww          , Ww          , Gs^Fp       , Gg          , Gg          , Gg          , Rrc         , Gg          , Gg          , Gg          , Gg          , Gg          , Gg          , Gg          , Rrc         , Gg          , Gg^Vh       , Gg          , Gg          , Gg          , Gg          
Gg          , Gg          , Gg          , Gg          , Gg          , Gg          , Rrc         , Rrc         , Gg          , Gg          , Gg          , Gg          , Ww          , Gs^Fp       , Gs^Fp       , Gg          , Gg          , Gg          , Rrc         , Gs^Fp       , Gs^Fp       , Gg          , Gg          , Gg^Efm      , Gg          , Gg          , Rrc         , Gg          , Gg          , Gg          , Gg          , Gg^Efm      , Gg          
Gg          , Gg          , Gg          , Gg^Vh       , Gg          , Gg          , Rrc         , Gg          , Gg          , Gg          , Gg          , Gg^Vh       , Gg          , Ww          , Gg          , Gg          , Gg          , Gg          , Gg          , Rrc         , Gg          , Gg          , Gg          , Gg^Efm      , Gg          , Hh          , Gg          , Rrc         , Rrc         , Gg          , Gg          , Gg          , Gg          
Gg          , Gg          , Gg          , Gg          , Gg          , Gg^Efm      , Rrc         , Gg          , Gg          , Gg          , Gg          , Gg          , Gg          , Ww          , Gg          , Gg          , Gg^Efm      , Gg^Efm      , Gg^Efm      , Rrc         , Gg          , Gg          , Gg          , Gg          , Gg          , Gg          , Gg          , Gg          , Rrc         , Gg          , Gg^Efm      , Gg          , Gg          
Gg          , Gg          , Gg          , Gg          , Gg^Efm      , Gg^Efm      , Rrc         , Hh          , Hh          , Gg          , Gg          , Gg          , Gg          , Ww          , Gg          , Gg          , Gg^Efm      , Gg^Efm      , Gg          , Rrc         , Gg          , Gg          , Gg          , Gg          , Gg          , Gg          , Gg          , Gg          , Rrc         , Gg          , Gg          , Re          , Re          
Gg          , Gg          , Gg          , Gg          , Rrc         , Rrc         , Rrc         , Rrc         , Rrc         , Gg^Efm      , Gg^Efm      , Gg          , Gg          , Ww          , Gg          , Gg          , Gg          , Gg          , Gg          , Rrc         , Gg          , Gg          , Re          , Gg          , Ce          , Ce          , Ce          , Gg          , Rrc         , Gg          , Gg          , Re          , Re          
Gg          , Gg          , Rrc         , Rrc         , Re          , Gg          , Ce          , Gg          , Gg          , Rrc         , Rrc         , Gg          , Gg          , Wwf         , Ds          , Gg          , Gg          , Gg^Vh       , Gg          , Rrc         , Re          , Re          , Re          , Gg          , Ce          , 3 Ket       , Ce          , Gg          , Rrc         , Gg          , Re          , Re          , Re          
Ds          , Ds          , Ds          , Re          , Re          , Ce          , 2 Ket       , Ce          , Gg          , Gg          , Gg          , Rrc         , Ds          , Wwf         , Ww          , Ds          , Ds          , Gg          , Gg          , Ds          , Ds          , Re          , Ds          , Ds          , Ds          , Ce          , Ds          , Gg          , Rrc         , Gg          , Ds          , Ds          , Ds          
Ds          , Ds          , Ds          , Ds          , Ds          , Ce          , Ce          , Ce          , Ds          , Ds          , Ds          , Ds          , Ds          , Ww          , Ww          , Ds          , Ds          , Ds          , Ds          , Ds          , Ds          , Ds          , Ds          , Ds          , Ww          , Ds          , Ds          , Ds          , Ds          , Ds          , Ds          , Ds          , Ds          
Ds          , Ds          , Ds          , Ds          , Ds          , Ds          , Ds          , Ds          , Ds          , Ds          , Ds          , Ds          , Ww^Bw|      , Ds          , Ww          , Ww          , Ds          , Ds          , Ds          , Ds          , Ds          , Ds          , Ww          , Ww          , Ww          , Ww          , Ww          , Ds          , Ds          , Ds          , Ds          , Ds          , Ds          
Ww          , Ww          , Ww          , Ds          , Ww^Bw|      , Ds          , Ds          , Ds          , Ds          , Ds          , Ww          , Ww          , Ww^Bw|      , Ww          , Ww          , Ww          , Ww          , Ww          , Ww          , Ds          , Ww          , Ww^Bw|      , Ww          , Ww          , Ww          , Ww          , Ww          , Ww          , Ww          , Ww^Bw|      , Ww          , Ds          , Ds          
Ww          , Ww          , Ww          , Ww          , Ww^Bw|      , Ww          , Ww          , Ww          , Ww          , Ww          , Ww          , Ww          , Ww^Bw|      , Ww          , Ww          , Ww          , Ww          , Ww          , Ww          , Ww          , Ww          , Ww^Bw|      , Ww          , Ww          , Ww          , Ww          , Ww          , Ww          , Ww          , Ww^Bw|      , Ww          , Ww          , Ww          
Ww          , Ww          , Ww          , Ww          , Ww^Bw|      , Ww          , Ww          , Ww          , Ww          , Ww          , Ww          , Ww          , Ww          , Ww          , Ww          , Ww          , Ww          , Ww          , Ww          , Ww          , Ww          , Ww^Bw|      , Ww          , Ww          , Ww          , Ww          , Ww          , Ww          , Ww          , Ww^Bw|      , Ww          , Ww          , Ww          
Ww          , Ww          , Ww          , Ww          , Ww          , Ww          , Ww          , Ww          , Ww          , Ww          , Ww          , Ww          , Ww          , Ww          , Ww          , Ww          , Ww          , Ww          , Ww          , Ww          , Ww          , Ww          , Ww          , Ww          , Wo          , Ww          , Ww          , Wo          , Wo          , Ww          , Ww          , Ww          , Ww          
Ww          , Ww          , Wo          , Ww          , Wo          , Ww          , Ww          , Ww          , Wo          , Ww^Vm       , Wo          , Ww          , Wo          , Wo          , Wo          , Ww          , Wo          , Wo          , Wo          , Ww^Vm       , Wo          , Wo          , Wo          , Wo          , Wo          , Wo          , Wo          , Wo          , Wo          , Wo          , Wo          , Ww^Vm       , Ww          
Wo          , Wo          , Wo          , Wo          , Wo          , Wo          , Wo          , Wo          , Wo          , Wo          , Wo          , Wo          , Wo          , Wo          , Wo          , Wo          , Wo          , Wo          , Wo          , Wo          , Wo          , Wo          , Wo          , Wo          , Wo          , Wo          , Wo          , Wo          , Wo          , Wo          , Wo          , Wo          , Wo          
Wo          , Wo          , Wo          , Wo          , Wo          , Wo          , Wo          , Wo          , Wo          , Wo          , Wo          , Wo          , Wo          , Wo          , Wo          , Wo          , Wo          , Wo          , Wo          , Wo          , Wo          , Wo          , Wo          , Wo          , Wo          , Wo          , Wo          , Wo          , Wo          , Wo          , Wo          , Wo          , Wo          
