border_size=1
usage=map

Wo          , Wo          , Wo          , Wo          , Wo          , Wo          , Wo          , Wo          , Wo          , Wo          , Wo          , Wo          , Wo          , Wo          , Wo          , Wo          , Wo          , Wo          , Wo          , Wo          , Wog         , Wog         , Wog         , Wo          , Wog         , Wo          , Wo          , Wo          , Wo          , Wo          , Wo          , Wo          
Wo          , Wo          , Wo          , Wo          , Wo          , Wo          , Wo          , Wo          , Wo          , Wo          , Wo          , Wo          , Wo          , Wo          , Wo          , Wo          , Wo          , Wo          , Wo          , Wo          , Wo          , Wog         , Wog         , Wog         , Wo          , Wog         , Wo          , Wo          , Wo          , Wo          , Wo          , Wo          
Wog         , Wo          , Wo          , Wo          , Wo          , Wo          , Wo          , Wo          , Wo          , Wo          , Wog         , Wo          , Wo          , Wo          , Wo          , Wog         , Wog         , Wo          , Ww^Vm       , Wo          , Wo          , Wog         , Wog         , Wo          , Wo          , Wog         , Wo          , Wo          , Wo          , Wo          , Wog         , Wo          
Wo          , Wog         , Wog         , Wog         , Wo          , Wo          , Wo          , Wo          , Wo          , Wog         , Wog         , Wog         , Wo          , Wo          , Wo          , Wog         , Wo          , Wo          , Wo          , Wo          , Wo          , Wo          , Wo          , Wog         , Wog         , Wog         , Wo          , Wo          , Wo          , Wo          , Wog         , Wog         
Wo          , Wog         , Wog         , Wo          , Wo          , Wo          , Wo          , Ww^Vm       , Wo          , Wog         , Wog         , Wog         , Wo          , Wo          , Wo          , Wog         , Wog         , Wo          , Wo          , Wo          , Wo          , Wo          , Wo          , Wo          , Wo          , Wo          , Wo          , Wo          , Wo          , Wo          , Wo          , Wog         
Wo          , Wo          , Wog         , Wog         , Wo          , Wo          , Wo          , Wo          , Wo          , Wo          , Wo          , Wo          , Wo          , Wo          , Wo          , Wo          , Wog         , Wo          , Wo          , Wo          , Wo          , Wo          , Wo          , Wo          , Wog         , Wo          , Wo          , Wo          , Ww^Vm       , Wo          , Wo          , Wog         
Wo          , Wo          , Wo          , Wo          , Wo          , Wo          , Wo          , Wo          , Wo          , Wo          , Wo          , Wo          , Wo          , Wo          , Wo          , Wo          , Wog         , Wo          , Wo          , Wo          , Wo          , Wo          , Wwr         , Wog         , Wog         , Wog         , Wo          , Wo          , Wo          , Wo          , Wog         , Wog         
Wo          , Wo          , Wo          , Wo          , Wo          , Wo          , Wo          , Wo          , Wo          , Wo          , Wo          , Wo          , Wo          , Wo          , Wo          , Wo          , Wo          , Wog         , Wo          , Wo          , Wo          , Wo          , Wo          , Ww          , Wo          , Wog         , Wo          , Wo          , Wo          , Wo          , Wo          , Wo          
Ww          , Ww          , Ww          , Wo          , Wwg         , Ww          , Ww          , Wwr         , Ww          , Ww          , Wo          , Ww          , Wwg         , Ww          , Wwg         , Ww          , Wwg         , Wo          , Ww          , Ww          , Ww          , Ww          , Wwg         , Wwg         , Ww          , Ww          , Wo          , Wwr         , Ww          , Ww          , Ww          , Ww          
Ww          , Wwg         , Wwr         , Wwg         , Wwg         , Wwg         , Ww          , Ww          , Ww          , Wo          , Ww          , Ww          , Wwg         , Wwg         , Ds          , Wwg         , Wwg         , Ww          , Ww          , Ww          , Wwr         , Wwg         , Ww          , Wwg         , Ww          , Ww          , Ww          , Ww          , Wwg         , Wwg         , Wwg         , Ww          
Ss          , Ss          , Ss          , Wwg         , Wwg         , Ds          , Ce          , Ce          , Ce          , Ds          , Ds          , Ds          , Ss          , Ds          , Ss          , Ss          , Ss          , Ss          , Ds          , Ds          , Ss          , Ds          , Ss          , Ss          , Ss          , Ds          , Ds          , Ww          , Wwg         , Ds          , Sm          , Sm          
Ss          , Sm          , Sm          , Ss          , Ds          , Ds          , Ce          , 1 Ke        , Ce          , Ss          , Sm          , Ss          , Ss          , Ss          , Ss          , Ss          , Ss          , Ss          , Ss          , Ss          , Sm          , Sm          , Ss          , Ss          , Ss          , Ss          , Ss          , Wwg         , Ds          , Ds          , Sm          , Sm          
Ss          , Ss          , Sm          , Ss          , Ss          , Ds          , Ss          , Ce          , Ss          , Ss          , Sm          , Ss          , Ss^Vhs      , Ss          , Sm          , Sm          , Sm          , Ss          , Ss          , Sm          , Ss          , Sm          , Sm          , Ss          , Ss          , Ss          , Ss          , Ds          , Ss          , Ss          , Sm          , Sm          
Ss          , Ss          , Ss          , Ss          , Ss          , Ss          , Ss^Vhs      , Ss          , Sm          , Sm          , Sm          , Ss          , Ss          , Ss          , Ss          , Sm          , Sm          , Ss          , Ss          , Ss          , Ss          , Ss          , Ss          , Ss          , Ss          , Ss          , Ss          , Ss          , Ss^Vhs      , Ss          , Ss          , Ss          
Ss          , Ss          , Ss          , Ss          , Ss          , Ss          , Ss          , Ss          , Sm          , Sm          , Ss          , Ss          , Re          , Ss          , Hh          , Ss          , Ss          , Ss          , Ss          , Hh          , Ss          , Ss          , Ss          , Ss          , Ss          , Sm          , Sm          , Ss          , Ss          , Ss          , Sm          , Ss          
Ss          , Sm          , Sm          , Ss          , Ss          , Ss          , Sm          , Sm          , Ss          , Ss          , Ss          , Hhd         , Hhd         , Re          , Hh          , Hh          , Hhd         , Hh          , Hh          , Ss          , Hh          , Hh          , Hh          , Ss          , Hhd         , Sm          , Ss          , Sm          , Ss          , Ss          , Ss          , Sm          
Ss          , Ss          , Ss          , Ss          , Ss          , Ss          , Ss          , Ss          , Ss          , Ss          , Ss          , Hhd         , Hhd^Dr      , Re          , Re          , Hh          , Hh          , Hhd         , Hhd         , Hhd         , Hhd         , Hd          , Hd          , Hh          , Hhd         , Hhd         , Re          , Ss          , Ss          , Ss          , Sm          , Sm          
Ss          , Ss          , Ss          , Ss          , Hh          , Ss          , Hh          , Ss          , Ss          , Ss          , Hh          , Hhd         , Hh          , Hh          , Hh          , Re          , Hh          , Hh          , Hhd         , Hh          , Re          , Hh          , Re          , Re          , Re          , Re          , Hh          , Hh          , Ss          , Ss          , Ss          , Ss          
Hh          , Hh          , Hhd         , Ss          , Ss          , Hh          , Hh          , Hh          , Hhd         , Hh          , Hh          , Hh          , Hhd^Vhhr    , Hhd         , Hh          , Re          , Re          , Hh          , Re          , Re          , Hh          , Re          , Hh          , Hh          , Hh          , Hh          , Hhd         , Hhd         , Hhd         , Hhd         , Ss          , Ss          
Ss          , Ss          , Hhd         , Hhd^Dr      , Hh          , Ss          , Sm          , Hhd         , Hd          , Hhd         , Hhd         , Hh          , Hhd         , Hhd         , Hhd^Dr      , Hh          , Hh          , Re          , Hh          , Hh          , Hhd^Dr      , Hhd         , Hhd         , Hd          , Hd^Dr       , Hh^Dr       , Hd          , Hh          , Ss          , Ss          , Sm          , Ss          
Hh          , Hh          , Ss          , Ss          , Ss          , Hh          , Sm          , Hh          , Re          , Hh          , Hhd         , Hd          , Hd          , Hhd         , Hhd         , Hh          , Hh          , Re          , Hh          , Hhd         , Hh          , Hhd         , Hh          , Hd          , Hhd^Vhhr    , Hh^Dr       , Hd          , Hh          , Ss          , Sm          , Sm          , Ss          
Ss          , Ss          , Ss          , Ss          , Ss^Vhs      , Ss          , Sm          , Re          , Hh          , Re          , Re          , Hhd         , Hhd         , Hd          , Hh          , Hh          , Hhd         , Re          , Hh          , Hh          , Ss          , Ss          , Hh          , Hhd         , Hhd         , Hh          , Hh          , Hh          , Ss          , Sm          , Ss          , Ss          
Ss          , Sm          , Sm          , Ss          , Ss          , Ss          , Hh          , Sm          , Sm          , Hh          , Hh          , Re          , Re          , Hhd         , Ss          , Ss          , Ss          , Ss          , Ss          , Ss          , Ss          , Ss          , Hh          , Hhd         , Ss          , Ss          , Ss          , Hh          , Hh          , Sm          , Hhd         , Hhd         
Sm          , Ss          , Sm          , Ss          , Ss          , Hh          , Hd          , Hh          , Hh          , Ss          , Hh          , Hh          , Ss          , Ss          , Sm          , Sm          , Ss          , Ss          , Ss          , Ss          , Sm          , Ss          , Hh          , Hhd         , Hhd         , Ss          , Ss          , Hh          , Hh          , Hhd         , Ss          , Ss          
Sm          , Ss          , Sm          , Ss          , Hh          , Hh          , Hhd         , Hh          , Ss          , Ss          , Hhd         , Hh          , Ss          , Ss          , Sm          , Ss          , Chs         , Chs         , Chs         , Ss          , Sm          , Ss          , Ss          , Hh          , Ss          , Ss^Vhs      , Ss          , Ss          , Ss          , Hh          , Sm          , Ss          
Ss          , Sm          , Sm          , Ss          , Ss          , Hhd         , Ss          , Hh^Dr       , Ss          , Hh          , Hh          , Hhd         , Re          , Sm          , Sm          , Ss          , Chs         , 2 Khs       , Chs         , Ss          , Sm          , Sm          , Ss          , Ss          , Hh          , Ss          , Ss          , Sm          , Sm          , Sm          , Sm          , Ss          
Ss          , Sm          , Ss          , Ss          , Hh          , Hh          , Hhd         , Hh          , Hh          , Ss          , Ss          , Re          , Hh          , Ss          , Sm          , Ss          , Ss          , Chs         , Ss          , Ss          , Ss          , Ss          , Hh          , Hh          , Hhd         , Ss          , Hh          , Ss          , Hh          , Ss          , Ss          , Ss          
Ss          , Ss          , Ss          , Ss          , Hh          , Hd          , Hd          , Hh          , Re          , Re          , Ss          , Hh          , Hhd         , Ss          , Sm          , Sm          , Sm          , Ss          , Ss          , Ss          , Ss          , Re          , Re          , Hh          , Hhd         , Hhd         , Hhd         , Hd          , Hd          , Hh          , Hh          , Hh          
Ss          , Ss          , Ss          , Ss          , Hh          , Hd          , Re          , Re          , Hh          , Hh          , Ss          , Hh          , Hh          , Hh          , Ss          , Sm          , Ss          , Sm          , Ss          , Ss          , Hh          , Hh          , Hhd^Vhhr    , Re          , Re          , Hhd         , Hh          , Hh^Dr       , Hh^Dr       , Hd          , Hh          , Hh          
Sm          , Ss          , Ss          , Re          , Re          , Hh          , Re          , Hh          , Hhd         , Hhd         , Hhd^Dr      , Sm          , Sm          , Ss          , Hh          , Ss          , Hh          , Hhd         , Hd^Dr       , Hh          , Hhd         , Hhd         , Hhd         , Hh          , Hh          , Re          , Hh          , Hh          , Hhd         , Hhd         , Hh          , Hh          
Sm          , Sm          , Ss          , Hh          , Hh          , Re          , Hhd         , Hhd^Vhhr    , Hhd         , Hhd         , Hhd         , Hd          , Sm          , Hh          , Hhd         , Hhd         , Hhd         , Hhd         , Hd          , Hd          , Hd          , Hhd         , Hhd         , Hh          , Hh          , Re          , Re          , Hh          , Hhd         , Hhd         , Hhd         , Hh          
Sm          , Sm          , Ss          , Hh          , Hh          , Re          , Hh          , Hhd         , Hh          , Hh          , Hh          , Hd          , Sm          , Hh          , Hh          , Hh          , Hh          , Hh          , Hh          , Hh          , Hh          , Hh          , Hh          , Hh          , Hh          , Re          , Re          , Hh          , Hhd         , Hhd         , Hhd         , Hhd         
