border_size=1
usage=map

Mm^Xm       , Mm^Xm       , Mm^Xm       , Mm^Xm       , Mm^Xm       , Mm^Xm       , Mm^Xm       , Mm^Xm       , Mm          , Mm^Xm       , Mm^Xm       , Mm^Xm       , Mm^Xm       , Mm^Xm       , Mm^Xm       , Mm^Xm       , Mm          , Mm          , Mm          , Mm          , Mm^Xm       , Mm^Xm       , Mm^Xm       , Mm^Xm       , Mm          , Mm          , Mm          , Re          , Mm          , Mm^Xm       , Mm^Xm       , Mm^Xm       , Mm          , Mm          , Chr         , Mm          , Mm          
Mm^Xm       , Mm^Xm       , Mm^Xm       , Mm^Xm       , Mm^Xm       , Mm^Xm       , Mm^Xm       , Mm^Xm       , Mm          , Mm^Xm       , Mm^Xm       , Mm^Xm       , Mm^Xm       , Mm^Xm       , Mm^Xm       , Mm^Xm       , Mm          , Mm          , Mm^Vhhr     , Mm          , Mm^Xm       , Mm^Xm       , Mm^Xm       , Mm^Xm       , Mm          , Mm          , Mm^Vhhr     , Re          , Mm          , Mm^Xm       , Mm^Xm       , Mm^Xm       , Mm          , Mm          , Chr         , Mm          , Mm          
Mm^Xm       , Mm^Xm       , Mm          , Mm          , Mm          , Mm          , Re          , Mm          , Hhd^Vhhr    , Mm          , Mm          , Mm          , Hh          , Mm^Xm       , Mm          , Mm          , Hh^Dr       , Mm          , Mm          , Mm^Xm       , Mm          , Mm^Xm       , Mm          , Mm^Xm       , Mm          , Mm          , Mm          , Re          , Re          , Mm          , Mm          , Mm          , Re          , Chr         , 2 Khr       , Chr         , Chr         
Mm          , Mm          , Re          , Re          , Re          , Re          , Mm          , Re          , Re          , Re          , Re          , Hh          , Mm          , Hh          , Hh          , Hh          , Sm          , Sm          , Hh          , Mm          , Mm          , Mm          , Mm          , Mm          , Mm          , Mm          , Mm^Vhr      , Mm          , Mm          , Re          , Re          , Re          , Mm          , Chr         , Chr         , Chr         , Chr         
Re          , Re          , Hh          , Mm          , Mm          , Mm          , Hh          , Mm          , Mm          , Mm          , Hh          , Re          , Re          , Re          , Ss          , Sm          , Hh          , Hh          , Hh          , Hh          , Mm          , Mm          , Mm          , Mm          , Mm          , Mm          , Mm          , Mm          , Mm          , Mm          , Mm          , Re          , Re          , Mm          , Mm          , Mm          , Mm          
Hh          , Hh          , Mm          , Mm          , Mm          , Mm          , Hh          , Hh          , Hd          , Hd          , Hhd         , Hh          , Hh          , Hh          , Ss          , Re          , Re          , Re          , Re          , Hh          , Mm          , Mm^Vhhr     , Mm          , Mm          , Mm          , Mm          , Mm          , Mm          , Mm          , Mm          , Mm          , Mm          , Re          , Mm          , Mm          , Mm          , Mm          
Hhd         , Hh          , Hh          , Mm          , Hh          , Hh          , Hhd         , Hd          , Hd          , Hhd         , Hhd         , Hhd         , Hh          , Hh^Dr       , Ss          , Hh          , Re          , Hh          , Hh          , Re          , Re          , Mm          , Mm          , Mm          , Mm          , Mm          , Mm          , Mm          , Mm          , Mm          , Mm          , Mm^Vhhr     , Re          , Mm          , Mm          , Mm          , Mm          
Hhd         , Hh          , Hh          , Hh          , Hh          , Hhd         , Hh          , Hh          , Hd          , Hh          , Hh          , Hh          , Ss          , Ss          , Hh          , Hh          , Re          , Hh          , Hh          , Hh          , Hh          , Re          , Re          , Mm          , Mm          , Mm          , Hhd         , Hhd         , Hhd         , Mm          , Mm          , Mm^Xm       , Mm^Xm       , Re          , Re          , Mm^Xm       , Mm^Xm       
Hh          , Hhd         , Hd          , Hh          , Sm          , Hh          , Sm          , Sm          , Sm          , Hh          , Ss          , Ss          , Ss          , Hh          , Hhd         , Hh          , Re          , Mm          , Mm          , Hh          , Hh          , Hh          , Hh          , Re          , Re          , Hhd         , Mm          , Hhd         , Mm^Xm       , Mm          , Mm          , Mm          , Mm          , Mm^Xm       , Re          , Mm^Xm       , Mm^Xm       
Ss          , Ss          , Ss          , Ss          , Hh          , Sm          , Hh          , Hh          , Hh          , Ss          , Hh          , Hh          , Ss          , Hhd         , Hhd         , Hh          , Hh          , Re          , Re          , Mm          , Hh          , Hhd         , Hh          , Hh          , Hh          , Re          , Re          , Mm          , Mm          , Mm          , Ss          , Mm          , Re          , Re          , Re          , Mm^Xm       , Mm^Xm       
Hh          , Hh          , Hhd^Vhhr    , Hhd         , Hhd         , Hh          , Hhd         , Hhd^Vhr     , Hh          , Hh          , Hh^Dr       , Hh          , Ss          , Hh          , Hd          , Hhd         , Hhd         , Hh          , Re          , Mm          , Hh          , Hhd         , Hd          , Hhd^Vhr     , Hd          , Hh          , Hh          , Re          , Re          , Mm          , Ss          , Mm          , Re          , Mm          , Mm          , Mm^Xm       , Mm^Xm       
Re          , Re          , Re          , Hh          , Hh          , Hhd         , Hhd         , Hhd         , Hh          , Hh          , Hh          , Hh          , Ss          , Hh          , Hd          , Hd          , Hhd         , Hh          , Re          , Hh          , Hhd         , Hhd         , Hhd         , Hd          , Hh          , Hd          , Hh          , Hh          , Sm          , Ss          , Re          , Re          , Mm          , Hh          , Mm^Xm       , Mm^Xm       , Mm^Xm       
Sm          , Sm          , Hh          , Re          , Re          , Hh          , Hhd         , Hhd         , Hh^Dr       , Hh          , Mm          , Hh          , Hh          , Ss          , Hh          , Hd          , Hhd         , Hh          , Re          , Hh^Dr       , Hh          , Hhd         , Hhd         , Hh          , Hh          , Hh          , Sm          , Sm          , Hh          , Hh          , Re          , Hh          , Mm^Xm       , Mm^Xm       , Mm          , Mm          , Mm          
Hh          , Hh          , Ss          , Hh          , Hh          , Re          , Hh          , Hh          , Hh          , Hh          , Mm          , Hh          , Hh          , Ss          , Sm          , Hh          , Hhd         , Re          , Hh          , Hh          , Hh          , Hd          , Hd          , Hh          , Sm          , Sm          , Hh          , Hh          , Hhd         , Hh          , Re          , Mm          , Mm          , Mm          , Hhd^Vhhr    , Hh          , Hh          
Ss          , Ss          , Ss          , Ss          , Hh          , Re          , Re          , Hh          , Re          , Hh          , Hh          , Hh          , Hh          , Hh          , Sm          , Hh          , Hh          , Re          , Hh          , Hh          , Hh          , Hd          , Hh^Dr       , Hh          , Hh          , Sm          , Hh          , Hhd         , Hhd         , Hhd         , Re          , Mm          , Mm          , Mm          , Mm          , Mm          , Mm          
Ss          , Ss          , Hh          , Hh          , Hd          , Hh          , Hh          , Re          , Hh          , Re          , Re          , Hhd^Vhhr    , Hh          , Hh          , Sm          , Hh          , Re          , Re          , Hh          , Hh          , Hhd^Vhhr    , Hh          , Hh          , Hh          , Hh          , Ss          , Hhd         , Hhd         , Hh^Dr       , Hh          , Mm          , Re          , Hhd         , Mm          , Mm          , Mm          , Mm          
Ss          , Sm          , Sm          , Hd          , Sm          , Hh          , Ss          , Ss          , Hh          , Hh          , Hh          , Re          , Hh          , Hh          , Sm          , Sm          , Re          , Hh          , Hh          , Hh          , Mm          , Hh          , Hh          , Hh          , Hh          , Ss          , Hh          , Hhd         , Hh          , Mm          , Hh          , Re          , Hhd         , Hhd         , Mm          , Mm          , Mm          
Ss          , Sm          , Ss          , Sm          , Ss          , Sm          , Ss          , Hh          , Hh          , Hd          , Hd          , Re          , Re          , Sm          , Hh          , Hh          , Re          , Hh          , Hh          , Mm          , Mm          , Mm          , Hh          , Hd          , Hh          , Ss          , Hh          , Hh          , Mm          , Mm          , Hh          , Re          , Mm          , Hhd         , Mm          , Mm          , Mm          
Ss          , Ss          , Ss          , Hh          , Ss          , Ss          , Ss^Vhs      , Ss          , Ss          , Hd          , Hh          , Hh          , Ss          , Ss          , Re          , Re          , Hh^Dr       , Hh          , Mm          , Mm          , Hh          , Hh          , Hh          , Hh          , Ss          , Ss          , Ss          , Hh          , Hh          , Hh          , Re          , Re          , Re          , Mm          , Hh          , Mm          , Mm          
Ss          , Ss          , Ss          , Ss          , Ss          , Ss          , Ss          , Ss          , Ss          , Hh          , Ss          , Ss          , Hh          , Hh          , Re          , Hhd^Vhr     , Hh^Dr       , Hh          , Hhd         , Mm          , Mm          , Mm          , Hh          , Ss          , Hh          , Hh          , Hh          , Ss          , Hh          , Hh          , Re          , Hh          , Hh          , Re          , Re          , Re          , Re          
Ss          , Ss          , Ss          , Ss          , Ss          , Ss          , Ss          , Ss          , Ss          , Hh          , Ss          , Hh          , Hh          , Hh          , Hh          , Re          , Re          , Hh          , Hhd         , Hhd         , Hhd         , Hh          , Ss          , Ss          , Hh          , Hhd^Vhhr    , Hh          , Ss          , Ss          , Re          , Hh          , Hh          , Hhd         , Hh          , Hh          , Hh          , Hh          
Sm          , Sm          , Sm          , Ss          , Ss          , Ss          , Ss          , Ss          , Ss          , Ss          , Hh          , Hhd         , Hhd         , Ss          , Ss          , Hh          , Hh          , Re          , Re          , Hhd         , Ss          , Ss          , Hh          , Hh          , Hh          , Hhd         , Hh          , Re          , Hh          , Ss          , Hh          , Hhd         , Hhd         , Hhd^Vhhr    , Hh          , Hh          , Hd          
Ss          , Sm          , Sm          , Ss          , Ss          , Ss          , Ss          , Ss          , Ss          , Ss          , Hh          , Ss          , Hhd         , Hh          , Hh          , Hh          , Re          , Re          , Hh          , Sm          , Re          , Hh          , Hh          , Hh^Dr       , Hd          , Hhd         , Re          , Re          , Hh          , Ss          , Ss          , Hh          , Hh          , Hhd         , Hh          , Hd          , Hd          
Ss          , Ss          , Ss          , Sm          , Ss          , Ss^Vhs      , Ss          , Ss          , Ss          , Ss          , Ss          , Ss          , Ss          , Hh          , Re          , Re          , Hd          , Hd          , Hh          , Sm          , Re          , Hh          , Mm          , Hh          , Hh          , Hhd         , Re          , Hh          , Hh          , Ss          , Hh          , Ss          , Sm          , Hh          , Hh          , Hd          , Hd          
Ss          , Ss          , Sm          , Sm          , Ss          , Ss          , Ss          , Ss          , Ss          , Ss          , Ss          , Hh          , Hh          , Re          , Hh          , Hh          , Hd          , Hd          , Sm          , Sm          , Re          , Hh          , Hh          , Mm          , Mm          , Re          , Hh          , Hh          , Hh          , Ss          , Hh          , Hh          , Hh          , Sm          , Sm          , Hh          , Hh          
Ss          , Ss          , Ss          , Sm          , Sm          , Ss          , Ss          , Ss          , Ss          , Ss          , Ss          , Hh          , Re          , Re          , Ss          , Hh          , Hh          , Hh          , Sm          , Hh          , Hh          , Re          , Re          , Hh          , Hh          , Re          , Hh          , Hh          , Ss          , Ss          , Hh          , Hhd^Vhr     , Hh          , Hh          , Hh          , Ss          , Ss          
Ss          , Ss          , Ss          , Ss          , Ss          , Ss          , Ss          , Ss          , Ss          , Ss          , Ss          , Ss          , Ss          , Hh          , Hhd         , Hhd         , Ss          , Ss          , Hh          , Hh          , Hh          , Hh          , Hh          , Re          , Re          , Re          , Hh          , Hh          , Sm          , Hh          , Hhd         , Hhd^Dr      , Hhd^Dr      , Hh          , Hh          , Hh          , Hh          
Ss          , Ss          , Ss          , Ss          , Ss          , Ss          , Ss          , Sm          , Ss          , Ss          , Ss          , Ss          , Ss          , Hhd         , Hhd         , Ss          , Hh          , Hh          , Hhd         , Hhd         , Hhd         , Hh          , Hh          , Hh          , Re          , Hh          , Hh          , Sm          , Sm          , Hh          , Hhd         , Hhd         , Hd          , Hhd         , Hh          , Hh          , Hh          
Ss          , Ss          , Chs         , Ss          , Ss          , Ss          , Sm          , Sm          , Ss          , Ss          , Ss          , Ss          , Ss          , Hh          , Hh          , Ss          , Hh          , Hh          , Hh          , Hhd         , Hhd         , Hhd         , Hhd^Vhr     , Re          , Hh          , Hh          , Hhd         , Hh          , Ss          , Hh          , Hhd         , Hd          , Hd          , Hhd         , Hh          , Hh          , Hh          
Chs         , Chs         , 1 Khs       , Chs         , Ss          , Sm          , Sm          , Sm          , Ss          , Ss^Vhs      , Ss          , Ss          , Sm          , Ss          , Ss          , Ss          , Hh          , Hh^Dr       , Hh          , Hh          , Hd          , Hh          , Hh          , Re          , Hh          , Hh          , Hhd         , Hhd^Dr      , Hhd         , Ss          , Hh          , Hh          , Hd          , Hh          , Hhd^Vhhr    , Hh^Dr       , Hh          
Chs         , Chs         , Chs         , Chs         , Ss          , Sm          , Ss          , Ss          , Ss          , Ss          , Ss          , Ss          , Ss          , Sm          , Sm          , Sm          , Sm          , Hh          , Sm          , Hh          , Hh          , Hh          , Re          , Re          , Hh          , Hh          , Hh          , Hhd         , Hh          , Ss          , Sm          , Hh          , Hh          , Hh          , Hh          , Hh          , Hh          
Chs         , Chs         , Chs         , Chs         , Ss          , Ss          , Ss          , Ss          , Ss          , Ss          , Ss          , Ss          , Ss          , Sm          , Ss          , Sm          , Ss          , Hh          , Ss          , Hh          , Hh          , Hh          , Re          , Re          , Hh          , Hh          , Hh          , Hh          , Hh          , Sm          , Sm          , Hh          , Hh          , Hh          , Hh          , Hh          , Hh          
