border_size=1
usage=map

Md          , Md          , Md          , Md          , Md          , Md          , Xu          , Xu          , Uh          , Uh          , Uh          , Co          , Co          , Co          , Co          , Co          , Uh          , Uh          , Uh          , Xu          , Xu          , Md          , Md          , Md          , Md          , Md          , Md          
Md          , Md          , Md          , Md          , Md          , Md          , Xu          , Xu          , Uu^Vud      , Uu          , Uu          , Co          , Co          , Co          , Co          , Co          , Uu          , Uu          , Uu^Vud      , Xu          , Xu          , Md          , Md          , Md          , Md          , Md          , Md          
Md          , Md          , Md          , Md          , Md          , Md          , Md          , Xu          , Uh          , Uu          , Uu          , Co          , Co          , 2 Ko        , Co          , Co          , Uu          , Uu          , Uh          , Xu          , Md          , Md          , Md          , Md          , Md          , Md          , Md          
Md          , Md          , Md          , Md          , Md          , Md          , Md          , Xu          , Uu^Vud      , Uu          , Uu          , Uu          , Uu          , Co          , Uu          , Uu          , Uu          , Uu          , Uu^Vud      , Xu          , Md          , Md          , Md          , Md          , Md          , Md          , Md          
Md          , Md          , Md          , Md          , Md          , Md          , Md          , Xu          , Xu          , Uh          , Uu^Vud      , Uu          , Uu          , Uu          , Uu          , Uu          , Uu^Vud      , Uh          , Xu          , Xu          , Md          , Md          , Md          , Md          , Md          , Md          , Md          
Md          , Md          , Md          , Md          , Md          , Md          , Md          , Md          , Md          , Xu          , Xu          , Xu          , Uu          , Uu          , Uu          , Xu          , Xu          , Xu          , Md          , Md          , Md          , Md          , Md          , Md          , Md          , Md          , Md          
Md          , Md          , Md          , Md          , Sm          , Sm          , Sm          , Md          , Md          , Md          , Md          , Md          , Md          , Uu          , Md          , Md          , Md          , Md          , Md          , Md          , Md          , Md          , Md          , Md          , Md          , Md^Vhhr     , Md          
Md          , Md          , Md          , Md          , Sm          , Sm          , Sm          , Sm          , Md          , Md          , Md          , Md          , Md          , Rd          , Rd          , Md          , Md          , Md          , Md          , Md          , Md          , Md          , Md          , Md          , Md          , Md          , Md          
Rd          , Rd          , Rd          , Md^Vhhr     , Md          , Md          , Md          , Md          , Md          , Mv          , Md          , Md          , Md          , Rd          , Md^Vhhr     , Rd          , Rd          , Md          , Md          , Md          , Md          , Md          , Md          , Mv          , Md          , Md          , Md          
Md          , Md          , Rd          , Md          , Md          , Md          , Md          , Md          , Md          , Md          , Md          , Md          , Md          , Rd          , Md          , Md          , Md          , Rd          , Rd          , Md          , Md          , Md          , Md          , Md          , Md          , Md          , Md          
Md          , Md          , Rd          , Md          , Md          , Md          , Md          , Md          , Md          , Md          , Md          , Md          , Md          , Rd          , Md          , Md          , Md          , Md          , Md          , Rd          , Rd          , Md          , Md          , Md          , Md          , Md          , Md          
Md          , Md          , Md          , Rd          , Rd          , Md          , Md          , Md          , Md          , Md          , Md          , Md          , Rd          , Rd          , Md          , Md          , Md          , Md          , Md          , Md          , Md          , Rd          , Rd          , Md          , Rd          , Rd          , Rd          
Md          , Md          , Md          , Md          , Md          , Rd          , Md          , Md          , Md          , Md          , Rd          , Rd          , Md          , Md          , Md          , Md          , Md          , Md          , Md          , Md          , Md          , Md          , Md          , Rd          , Md          , Md          , Md          
Md          , Md          , Md          , Md          , Md          , Rd          , Md          , Md          , Rd          , Rd          , Rd          , Md          , Md          , Md          , Md          , Md          , Md          , Md          , Md          , Md          , Md          , Md          , Md          , Md          , Md          , Md          , Md          
Rd          , Rd          , Rd          , Md          , Rd          , Rd          , Rd          , Rd          , Md          , Md          , Md          , Rd          , Rd          , Md          , Md          , Md          , Md          , Sm          , Sm          , Md          , Md          , Mv          , Md          , Md          , Md          , Md          , Md          
Md          , Md          , Md          , Rd          , Md          , Md          , Md          , Md          , Md          , Md          , Md          , Md          , Md          , Rd          , Rd          , Md          , Md          , Md          , Md          , Md          , Md          , Md          , Md          , Md          , Md^Vhhr     , Md          , Md          
Md          , Md          , Md          , Md          , Md          , Md          , Md          , Md          , Md          , Md          , Md^Vhhr     , Md          , Md          , Md          , Md          , Rd          , Rd          , Md          , Md          , Md          , Md          , Md          , Md          , Md          , Md          , Md          , Md          
Md          , Md          , Md          , Md          , Md          , Md          , Md          , Md          , Md          , Md          , Md          , Md          , Md          , Md          , Md          , Md          , Rd          , Md          , Md          , Md          , Md          , Md          , Md          , Md          , Md          , Md          , Md          
Md          , Md          , Md          , Md          , Md          , Mv          , Md          , Md          , Md          , Md          , Md          , Md          , Md          , Md          , Rd          , Rd          , Md          , Rd          , Rd          , Md          , Rd          , Md          , Md          , Md          , Md          , Md          , Md          
Md          , Md          , Md          , Md          , Md          , Md          , Md          , Md          , Md          , Md          , Md          , Md          , Rd          , Rd          , Md          , Md          , Md          , Md          , Rd          , Rd          , Md          , Rd          , Rd          , Md          , Md          , Md          , Md          
Md          , Md          , Md          , Md          , Md          , Md          , Md          , Md          , Md          , Md          , Rd          , Rd          , Md          , Md          , Md          , Md          , Md          , Md          , Rd          , Md          , Md          , Md          , Md          , Rd          , Rd          , Rd          , Rd          
Md          , Md^Vhhr     , Rd          , Md          , Md          , Md          , Md          , Md          , Md          , Md          , Rd          , Md          , Md          , Md          , Md          , Md          , Md          , Md          , Rd          , Md          , Md          , Md          , Md          , Md          , Md          , Md          , Md          
Rd          , Rd          , Md          , Rd          , Rd          , Md          , Md          , Md          , Rd          , Rd          , Md          , Md          , Md          , Md          , Md          , Mv          , Md          , Md          , Md          , Rd          , Rd          , Md          , Md          , Md          , Md          , Md          , Md          
Md          , Md          , Md          , Md          , Md          , Rd          , Rd          , Rd          , Md          , Rd          , Rd          , Md          , Md          , Md          , Md          , Md          , Md          , Md          , Md          , Md          , Md          , Rd          , Md          , Md          , Md          , Md          , Md          
Md          , Md          , Md          , Md          , Md          , Md          , Md          , Md          , Rd          , Rd          , Md          , Rd          , Rd          , Md          , Md          , Md          , Md          , Md          , Md          , Md          , Md          , Rd          , Rd          , Md          , Md          , Md          , Md          
Md          , Md          , Md          , Md          , Md          , Md          , Md          , Rd          , Md          , Md          , Md          , Md          , Md          , Rd          , Rd          , Md          , Md          , Md          , Md          , Md          , Md          , Md          , Md          , Rd          , Rd          , Md          , Md          
Md          , Md          , Md          , Md          , Rd          , Md          , Md          , Rd          , Md          , Md          , Md          , Md          , Md          , Md          , Md          , Rd          , Rd          , Md          , Md          , Md          , Md          , Md          , Md          , Md          , Rd          , Md          , Md          
Md          , Md          , Md          , Rd          , Md          , Rd          , Rd          , Rd          , Md          , Md          , Md          , Md          , Md^Vhhr     , Md          , Md          , Md          , Rd          , Md          , Md          , Md          , Md          , Md          , Md          , Md          , Md          , Rd          , Rd          
Md          , Md^Vhhr     , Rd          , Rd          , Md          , Md          , Md          , Md          , Md          , Md          , Md          , Md          , Md          , Md          , Rd          , Rd          , Md          , Md          , Md          , Md          , Md          , Md          , Md          , Md          , Md          , Rd          , Rd          
Md          , Md          , Rd          , Md          , Md          , Md          , Md          , Md          , Md          , Mv          , Md          , Md          , Md          , Rd          , Md          , Md          , Md          , Md          , Md          , Md          , Sm          , Md          , Md          , Md          , Md          , Md          , Md          
Rd          , Rd          , Md          , Md          , Md          , Md          , Sm          , Md          , Md          , Md          , Md          , Md          , Md          , Rd          , Md          , Md          , Md          , Md          , Md          , Md          , Sm          , Sm          , Md^Vhhr     , Md          , Md          , Md          , Md          
Md          , Md          , Md          , Md          , Md          , Md          , Sm          , Sm          , Md          , Md          , Md          , Md          , Md          , Rd          , Md          , Md          , Md          , Md          , Md          , Md          , Md          , Md          , Md          , Md          , Md          , Md          , Md          
Md          , Md          , Md          , Md          , Md          , Md          , Md          , Sm          , Md          , Md          , Md          , Md          , Md          , Rd          , Rd          , Md          , Md          , Md          , Md          , Md          , Md          , Md          , Md          , Md          , Md          , Md          , Md          
Rd          , Rd          , Rd          , Md          , Md          , Md          , Md          , Md          , Md          , Md          , Md          , Md          , Md          , Md          , Md          , Rd          , Md          , Md          , Md          , Md          , Mv          , Md          , Md          , Md          , Md          , Md          , Md          
Md          , Md          , Md          , Rd          , Rd          , Md          , Md          , Md          , Md          , Md          , Md          , Md          , Md          , Md          , Md          , Rd          , Md          , Md          , Md          , Md          , Md          , Md          , Md          , Md          , Sm          , Md          , Md          
Md          , Md          , Md          , Md          , Md          , Rd          , Rd          , Md          , Md          , Md          , Md          , Md          , Md          , Md          , Md          , Rd          , Rd          , Md          , Md          , Md          , Md          , Md          , Md          , Md          , Sm          , Sm          , Sm          
Md          , Md          , Md          , Md          , Md          , Md          , Md          , Rd          , Rd          , Md          , Md          , Md          , Md          , Md          , Md          , Md          , Md          , Rd          , Rd          , Md          , Md          , Md          , Sm          , Sm          , Md          , Md          , Md          
Md          , Md          , Md          , Md          , Mv          , Md          , Md          , Md          , Md          , Rd          , Rd          , Md          , Hhd         , Md          , Md          , Md          , Md          , Md          , Md          , Rd          , Rd          , Sm          , Md          , Md          , Md          , Md          , Md          
Md          , Md^Vhhr     , Md          , Md          , Md          , Md          , Md          , Md          , Md          , Md          , Rd          , Md          , Ce          , Hhd         , Hhd         , Md          , Md          , Md          , Md          , Md          , Rd          , Sm          , Md          , Md          , Md          , Md          , Md          
Md          , Md          , Md          , Md          , Md          , Md          , Md          , Md          , Rd          , Rd          , Hhd         , Ce          , 1 Ket       , Ce          , Hhd         , Hhd         , Hhd         , Md          , Md          , Md          , Rd          , Sm          , Md          , Md          , Md          , Hhd         , Hhd         
Hhd         , Hhd         , Hhd         , Md          , Md          , Md          , Rd          , Rd          , Hhd         , Hhd         , Hhd         , Ce          , Ce          , Ce          , Hhd         , Hhd         , Hhd         , Md          , Rd          , Rd          , Sm          , Sm          , Md          , Md^Vhhr     , Hhd         , Hhd         , Hhd         
Hhd         , Hhd         , Hhd         , Md          , Md          , Md          , Rd          , Rd          , Hhd         , Hhd         , Hhd         , Ce          , Ce          , Ce          , Hhd         , Hhd         , Hhd         , Md          , Rd          , Rd          , Sm          , Sm          , Md          , Md          , Hhd         , Hhd         , Hhd         
