border_size=1
usage=map

1 Kh, 2 Kh
